1111111111111111111111111111111111111
1000300000000000000000000002222222221
1000300000000000000000000002222222221
1000300000000000000000000002222222221
1000300000000000000000000002222222221
1000300000000001000000000000000000001
1000000000200000000000000000000000001
1000000000200000000000000000000000001
1000000000000000000000000000000000001
1000000000000000000000000000000000001
1000000000000000000000000000000000001
1000000000000000000000000000000000001
1000000000000000000000000000000000001
1000000000000000000000000000000000001
1000000000000000000000000000000000001
1000000000000000000000000000000000001
1000000000000000000000000000000000001
1000000000000000000000000000000000001
1000000000000000000000000000000000001
1111111111111111111111111111111111111