11111111111111111111111111111111111111
10003100000100000000000000000000000011
10003010000100000000000000000000000011
10000320400100000000000000000000000011
10003010000100000000000000002223222211
10003010000000000000000000222222222211
10010011111100000000000002222223222211
10010000000100000000100002222222222211
10010000000100000001000012222223222211
10010000000100000010000122222222222211
10010000000100000100001222222223222211
10010000000100001000010022222222222211
10010000000100010000100002222223222211
10010000000100100001000000022222222211
10010000000101000010000000000000000011
10010000000110000100000000000000000011
10010000000100001000000000000000000011
10010000000000010000000000000000000011
10010000000000100000000000000000000011
11111111111111111111111111111111111111
11111111111111111111111111111111111111