11111111111111111111111111112
10003000000000000000000000012
10003000000000000000000000012
10003000000000000000000000012
10003000000000000000000000012
10003000000000010000000000012
10000000002000000000000000012
10000000002000000000000000012
10000000000000000000000000012
11111111111111111111111111112
22222222222222222222222222222