11111111111111111111111111111111111111
10001110000000000000000000000000000001
10100000000000000000000000400000000001
10320000000000000000000000000000000001
11000000000000011000000000000000000001
10000000330000000100000000000000000001
10000000220000000010000000000000000001
10000000000000001000000000000000000001
10000000000000010000000000000000000001
10000000000000000000000110000000000001
10000000000000000000001001000000000001
10000000000000000000000000000000000001
10000000000011100000000000000000000001
10000000000000001000000000000000000001
10000000000000000000000000000000000001
10000000000000000000000000000000000001
10000000000000000000000000000000000001
10000000000000000000000000000000000001
10000000000000000000000000000000000001
10000000000000000000000000000000000001
11111111111111111111111111111111111111