1111111111111111111111111111111111111
1000310000010000000000000000000000001
1000301000010000000000000000000400001
1000301020010000000000000000000000001
1000301000010000000000000000000000001
1000301000000000000000000000000000001
1001001111110000000000000000000000001
1001000000010000000010000000000000001
1001000000010000000100001222222222221
1001000000010000001000012222222222221
1001000000010000010000122222222222221
1001000000010000100001002222222222221
1001000000010001000010000222222222221
1001000000010010000100000002222222221
1001000000010100001000000000000000001
1001000000011000010000000000000000001
1001000000010000100000000000000000001
1001000000000001000000000000000000001
1001000000000010000000000000000000001
1111111111111111111111111111111111111